US-Wis	US-Wis
Wisconsin-WI	US-Wis2
US-Wat	US-Wat
US-Sok	US-Sok
US-Sdi	US-Sdi
US-Nca	US-Nca
US-Haw	US-Haw
US-Col	US-Col
California-CA	US-CAOx
BR-Pal	BR-Pal
Trento-TR	IT-Tre2
IT-Tre	IT-Tre
FR-Run	FR-Run
FR-Par	FR-Par
Montpelier-MT	FR-Lez2
FR-Lez	FR-Lez
FR-Cor	FR-Cor
ES-Bar	ES-Bar
Jena-JN	DE-Jen2
DE-Jen	DE-Jen
DE-Dos	DE-Dos
CN-Shi	CN-Shi
CN-Nin	CN-Nin
CN-Lia	CN-Lia
CN-Bei	CN-Bei
JP-Tok	JP-Tok
JP-Sap	JP-Sap
Kanazawa-KZ	JP-Kan
Hokkaido-HK	JP-Sap2